wwwwwwww
w.....Aw
w......w
w.waw..w
w...w..w
ww....ww
w...w..w
w......w
wwwwwwww