wwwwwwwwwwwww
w...........w
w...........w
w......R....w
w...........w
w...........w
w......b....w
w...........w
wwwwwwwwwwwww