wwwwwwwwwwwww
w...........w
w.wwwwwwwww.w
w.w..2.v.v..w
w.w.........w
w.w.wwwwwwwww
w.w..2......w
w.w.......vvw
w.w....2..vvw
w.wwwwwwwwwww
wA........+gw
wwwwwwwwwwwww
wwwwwwlwwwwww