wwwwwwww
w......w
w.A....w
w......w
w......w
w.s..a.w
w......w
wwwwwwww